R 1080 640

NO  ./xpm/wall.xpm
WE  ./xpm/wood.xpm
EA ./xpm/purplestone.xpm
SO  ./xpm/brown.xpm

S ./xpm/barrel.xpm

F  60,  155 ,  60
C  6, 70,90

11111111111111111111111111
10000000010000000000S00001
10110000010100020202000001
100100000000010000020202021
111111111011000001000000001
10000000001100011100001111111
11110111111111011100000010001
11110111111111011101010010001
11000000110101011100000010001
10000000000000001100000000001
10000000000000000001010010001
110000010101010111110111100111
1111011101110101 101111010001
11111111 1111111 111111111111
